************************************************************
*******            *****************                    ****
***      ****************************************       ****
***               ***************                  *********
***      *******************     ********      *************
****              ***********             ******************
******            ****************    **********************
********    *****************          *********************         
********    **********************            **************
********    **********************               ***********
********         ***************             ***************
**************   ************         **********************
**************    *******        ***************************
***************                *****************************
***************        *****       **********      *********
****************     **********           ***      *********
****************     **********                 ************
*****************    **************             ************
****************                             ***************
************************************************************
